40
40
25 25 25 25 25 25 25 25 25 25 25 25 25 25 25 25 20 20 20 20 20 20 20 20 20 20 20 20 20 20 20 20 20 20 20 20 20 20 20 20
25 25 25 25 16 16 25 25 25 25 25 25 25 25 25 25 20 20 20 20 20 20 20 20 20 20 20 20 20 20 20 20 20 20 20 20 20 20 20 20
25 25 17 16 16 17 16 16 25 25 17 16 17 25 25 25 20 20 20 20 20 11 11 11 11 20 20 20 20 20 20 11 11 11 11 11 11 20 20 20
25 25 16 16 17 16 16 16 16 16 16 22 22 22 25 25 20 20 20 20 11 11 13 12 11 11 20 20 20 20 11 13 11 12 11 12 11 11 20 20
25 25 16 16 16 16 16 16 16 16 22 22 22 22 25 25 20 20 20 11 12 11 11 11 11 11 11 22 22 11 11 13 11 11 11 13 11 11 20 20
25 25 17 16 16 16 17 16 17 17 22 22 22 22 25 25 20 20 20 11 11 11 11 11 11 12 11 22 22 11 11 11 13 11 12 11 11 20 20 20
25 25 25 16 16 25 25 25 25 17 22 22 22 25 25 25 20 20 11 11 13 13 11 20 20 11 11 22 22 22 11 11 12 11 11 11 20 20 20 20
25 25 25 25 25 25 25 25 25 25 22 22 22 25 25 25 20 20 11 11 20 20 20 20 20 20 20 22 22 22 20 20 20 20 20 20 20 20 20 20
25 25 25 25 25 25 25 25 25 25 22 22 22 25 25 25 20 20 11 11 20 20 20 20 20 20 20 22 22 22 20 20 20 20 20 20 20 20 20 20
25 25 25 25 25 25 25 25 25 16 16 22 22 16 16 25 20 20 11 13 20 20 20 20 20 20 22 22 22 22 20 20 20 20 20 20 20 20 20 20
25 25 25 16 16 16 16 25 25 16 16 22 22 22 16 25 20 11 11 11 11 20 20 20 20 22 22 22 22 22 20 20 20 20 11 11 20 20 20 20
25 25 16 16 16 16 16 25 25 16 22 22 22 22 17 25 20 11 12 11 11 11 20 20 20 22 22 22 22 20 20 20 20 11 13 11 11 20 20 20
25 25 16 16 16 16 16 16 16 16 22 22 22 22 16 16 11 11 11 12 11 12 20 20 20 22 22 20 20 20 20 20 20 11 12 11 11 13 20 20
25 25 16 16 16 16 16 25 25 16 22 22 22 16 16 16 13 11 13 11 11 11 20 20 20 13 11 20 20 11 11 13 11 11 12 11 11 11 20 20
25 25 25 16 16 16 16 25 25 16 16 22 22 17 16 25 20 12 11 11 11 20 20 20 20 11 12 11 20 11 20 20 20 11 11 11 11 20 20 20
25 25 25 25 16 25 25 25 25 25 25 25 25 25 17 25 20 20 20 20 20 20 20 20 20 20 20 11 20 12 20 20 20 20 20 11 12 20 20 20
25 25 25 25 16 25 25 25 25 25 25 25 25 25 16 25 20 20 20 20 20 20 20 20 20 20 20 11 20 11 20 20 20 20 20 11 11 20 20 20
25 25 25 25 26 25 25 25 25 25 25 16 16 17 16 25 20 11 11 11 11 11 11 20 20 12 13 11 20 11 20 20 20 20 20 13 11 20 20 20
25 25 17 16 16 25 25 25 25 25 16 16 25 25 25 25 20 11 11 13 11 12 11 20 20 21 20 20 20 12 11 20 20 20 20 11 11 20 20 20
25 25 16 25 25 25 25 25 25 16 16 25 25 25 25 25 20 11 12 11 11 13 11 20 20 13 11 12 20 20 11 20 20 20 20 20 11 20 20 20
25 25 16 17 16 17 16 16 16 17 16 25 25 25 16 16 21 11 11 12 11 12 11 20 20 11 20 11 13 11 11 20 20 20 20 20 12 20 20 20
25 25 25 25 25 25 25 25 25 16 16 16 25 25 25 25 20 11 13 12 11 11 13 20 20 12 20 20 20 20 20 20 20 20 20 20 11 20 20 20
25 25 25 25 25 25 25 25 25 25 16 16 25 25 25 25 20 13 11 11 11 11 11 20 20 11 11 13 11 13 11 20 20 20 20 20 13 20 20 20
25 25 25 25 25 25 25 25 25 25 25 16 25 25 25 25 20 20 20 20 20 20 20 20 20 20 20 20 20 20 11 20 20 20 20 20 11 20 20 20
25 25 25 25 25 25 25 25 25 25 25 26 25 25 25 25 41 41 41 32 32 41 41 41 41 41 41 41 41 41 32 41 41 41 41 41 32 41 41 41
25 25 25 25 25 25 25 25 25 25 25 16 22 25 25 25 41 41 32 32 32 41 41 41 41 41 41 42 32 32 32 41 41 41 41 41 32 42 32 41
25 25 25 16 16 25 25 25 25 16 17 16 22 22 25 25 41 41 32 32 32 42 41 41 41 41 32 32 32 32 32 41 41 41 41 41 42 32 42 41
25 25 16 16 16 17 16 25 16 16 16 22 22 22 22 25 41 41 32 42 32 32 41 41 41 32 32 42 32 32 32 42 32 42 41 41 41 42 41 41
25 25 16 17 16 17 16 25 16 16 22 22 22 22 16 25 41 32 32 32 42 32 41 41 41 32 32 32 32 42 32 32 32 32 32 41 41 41 41 41
25 25 25 16 16 16 16 25 25 25 22 22 22 16 16 16 32 42 32 32 32 32 41 41 41 42 32 32 32 32 41 41 41 42 32 22 22 22 22 41
25 25 25 16 16 17 16 25 25 25 25 22 22 25 25 25 41 32 41 41 41 32 32 32 32 32 42 32 32 41 41 41 41 32 22 22 22 22 22 41
25 25 25 17 16 25 25 25 25 25 25 25 25 25 25 25 41 41 41 41 41 41 41 41 41 41 41 41 41 41 41 41 41 41 41 22 22 22 22 41
25 25 25 16 16 25 25 25 25 25 25 25 25 25 25 25 41 32 41 41 41 32 41 41 41 41 41 41 41 41 41 41 41 41 41 22 22 22 22 41
25 25 25 16 16 25 25 25 25 25 25 25 25 25 16 16 32 42 41 41 41 32 32 32 32 42 32 41 41 41 41 41 41 41 22 22 22 22 22 41
25 25 16 16 16 25 25 25 25 25 25 16 16 16 17 25 41 41 41 41 41 32 42 32 32 32 32 32 41 41 41 41 41 41 22 22 22 22 22 41
25 25 17 16 16 25 25 25 25 25 25 17 25 25 25 25 41 41 41 41 32 32 32 42 32 42 32 42 32 41 41 41 41 41 22 22 22 22 22 41
25 25 16 16 17 16 25 25 25 25 25 26 25 25 25 25 41 41 41 41 32 32 32 32 32 32 32 32 32 41 41 41 41 41 41 22 22 22 41 41
25 25 25 16 16 16 16 16 16 16 17 16 25 25 25 25 41 41 41 41 41 42 32 32 42 32 32 32 41 41 41 41 41 41 41 32 32 32 41 41
25 25 25 25 16 17 25 25 25 25 25 25 25 25 25 25 41 41 41 41 41 41 41 41 41 32 32 41 41 41 41 41 41 41 41 41 32 41 41 41
25 25 25 25 25 25 25 25 25 25 25 25 25 25 25 25 41 41 41 41 41 41 41 41 41 41 41 41 41 41 41 41 41 41 41 41 41 41 41 41