40
40
25 25 25 25 25 25 25 25 25 25 25 25 25 25 25 25 20 20 20 20 20 20 20 20 20 20 20 20 20 20 20 20 20 20 20 20 20 20 20 20 
25 25 25 25 17 17 25 25 25 25 25 25 25 25 25 25 20 20 20 20 20 20 20 20 20 20 20 20 20 20 20 20 20 20 20 20 20 20 20 20 
25 25 18 17 17 18 17 17 25 25 18 17 18 25 25 25 20 20 20 20 20 11 11 11 11 20 20 20 20 20 20 11 11 11 11 11 11 20 20 20 
25 25 17 17 18 17 17 17 17 17 17 22 22 22 25 25 20 20 20 20 11 11 13 12 11 11 20 20 20 20 11 13 11 12 11 12 11 11 20 20 
25 25 17 17 17 17 17 17 17 17 22 22 22 22 25 25 20 20 20 11 12 11 11 11 11 11 11 22 22 11 11 13 11 11 11 13 11 11 20 20 
25 25 18 17 17 17 18 17 18 18 22 22 22 22 25 25 20 20 20 11 11 11 11 11 11 12 11 22 22 11 11 11 13 11 12 11 11 20 20 20 
25 25 25 17 17 25 25 25 25 18 22 22 22 25 25 25 20 20 11 11 13 13 11 20 20 11 11 22 22 22 11 11 12 11 11 11 20 20 20 20 
25 25 25 25 25 25 25 25 25 25 22 22 22 25 25 25 20 20 11 11 20 20 20 20 20 20 20 22 22 22 20 20 20 20 20 20 20 20 20 20 
25 25 25 25 25 25 25 25 25 25 22 22 22 25 25 25 20 20 11 11 20 20 20 20 20 20 20 22 22 22 20 20 20 20 20 20 20 20 20 20 
25 25 25 25 25 25 25 25 25 17 17 22 22 17 17 25 20 20 11 13 20 20 20 20 20 20 22 22 22 22 20 20 20 20 20 20 20 20 20 20 
25 25 25 17 17 17 17 25 25 17 17 22 22 22 17 25 20 11 11 11 11 20 20 20 20 22 22 22 22 22 20 20 20 20 11 11 20 20 20 20 
25 25 17 17 17 17 17 25 25 17 22 22 22 22 18 25 20 11 12 11 11 11 20 20 20 22 22 22 22 20 20 20 20 11 13 11 11 20 20 20 
25 25 17 17 17 17 17 17 17 17 22 22 22 22 17 17 11 11 11 12 11 12 20 20 20 22 22 20 20 20 20 20 20 11 12 11 11 13 20 20 
25 25 17 17 17 17 17 25 25 17 22 22 22 17 17 17 13 11 13 11 11 11 20 20 20 13 11 20 20 11 11 13 11 11 12 11 11 11 20 20 
25 25 25 17 17 17 17 25 25 17 17 22 22 18 17 25 20 12 11 11 11 20 20 20 20 11 12 11 20 11 20 20 20 11 11 11 11 20 20 20 
25 25 25 25 17 25 25 25 25 25 25 25 25 25 18 25 20 20 20 20 20 20 20 20 20 20 20 11 20 12 20 20 20 20 20 11 12 20 20 20 
25 25 25 25 17 25 25 25 25 25 25 25 25 25 17 25 20 20 20 20 20 20 20 20 20 20 20 11 20 11 20 20 20 20 20 11 11 20 20 20 
25 25 25 25 26 25 25 25 25 25 25 17 17 18 17 25 20 11 11 11 11 11 11 20 20 12 13 11 20 11 20 20 20 20 20 13 11 20 20 20 
25 25 18 17 17 25 25 25 25 25 17 17 25 25 25 25 20 11 11 13 11 12 11 20 20 21 20 20 20 12 11 20 20 20 20 11 11 20 20 20 
25 25 17 25 25 25 25 25 25 17 17 25 25 25 25 25 20 11 12 11 11 13 11 20 20 13 11 12 20 20 11 20 20 20 20 20 11 20 20 20 
25 25 17 18 17 18 17 17 17 18 17 25 25 25 17 17 21 11 11 12 11 12 11 20 20 11 20 11 13 11 11 20 20 20 20 20 12 20 20 20 
25 25 25 25 25 25 25 25 25 17 17 17 25 25 25 25 20 11 13 12 11 11 13 20 20 12 20 20 20 20 20 20 20 20 20 20 11 20 20 20 
25 25 25 25 25 25 25 25 25 25 17 17 25 25 25 25 20 13 11 11 11 11 11 20 20 11 11 13 11 13 11 20 20 20 20 20 13 20 20 20 
25 25 25 25 25 25 25 25 25 25 25 17 25 25 25 25 20 20 20 20 20 20 20 20 20 20 20 20 20 20 11 20 20 20 20 20 11 20 20 20 
25 25 25 25 25 25 25 25 25 25 25 26 25 25 25 25 41 41 41 32 32 41 41 41 41 41 41 41 41 41 32 41 41 41 41 41 32 41 41 41 
25 25 25 25 25 25 25 25 25 25 25 17 22 25 25 25 41 41 32 32 32 41 41 41 41 41 41 42 32 32 32 41 41 41 41 41 32 42 32 41 
25 25 25 17 17 25 25 25 25 17 18 17 22 22 25 25 41 41 32 32 32 42 41 41 41 41 32 32 32 32 32 41 41 41 41 41 42 32 42 41 
25 25 17 17 17 18 17 25 17 17 17 22 22 22 22 25 41 41 32 42 32 32 41 41 41 32 32 42 32 32 32 42 32 42 41 41 41 42 41 41 
25 25 17 18 17 18 17 25 17 17 22 22 22 22 17 25 41 32 32 32 42 32 41 41 41 32 32 32 32 42 32 32 32 32 32 41 41 41 41 41 
25 25 25 17 17 17 17 25 25 25 22 22 22 17 17 17 32 42 32 32 32 32 41 41 41 42 32 32 32 32 41 41 41 42 32 22 22 22 22 41 
25 25 25 17 17 18 17 25 25 25 25 22 22 25 25 25 41 32 41 41 41 32 32 32 32 32 42 32 32 41 41 41 41 32 22 22 22 22 22 41 
25 25 25 18 17 25 25 25 25 25 25 25 25 25 25 25 41 41 41 41 41 41 41 41 41 41 41 41 41 41 41 41 41 41 41 22 22 22 22 41 
25 25 25 17 17 25 25 25 25 25 25 25 25 25 25 25 41 32 41 41 41 32 41 41 41 41 41 41 41 41 41 41 41 41 41 22 22 22 22 41 
25 25 25 17 17 25 25 25 25 25 25 25 25 25 17 17 32 42 41 41 41 32 32 32 32 42 32 41 41 41 41 41 41 41 22 22 22 22 22 41 
25 25 17 17 17 25 25 25 25 25 25 17 17 17 18 25 41 41 41 41 41 32 42 32 32 32 32 32 41 41 41 41 41 41 22 22 22 22 22 41 
25 25 18 17 17 25 25 25 25 25 25 18 25 25 25 25 41 41 41 41 32 32 32 42 32 42 32 42 32 41 41 41 41 41 22 22 22 22 22 41 
25 25 17 17 18 17 25 25 25 25 25 26 25 25 25 25 41 41 41 41 32 32 32 32 32 32 32 32 32 41 41 41 41 41 41 22 22 22 41 41 
25 25 25 17 17 17 17 17 17 17 18 17 25 25 25 25 41 41 41 41 41 42 32 32 42 32 32 32 41 41 41 41 41 41 41 32 32 32 41 41 
25 25 25 25 17 18 25 25 25 25 25 25 25 25 25 25 41 41 41 41 41 41 41 41 41 32 32 41 41 41 41 41 41 41 41 41 32 41 41 41 
25 25 25 25 25 25 25 25 25 25 25 25 25 25 25 25 41 41 41 41 41 41 41 41 41 41 41 41 41 41 41 41 41 41 41 41 41 41 41 41 
